............................
............................
........R...................
............................
.......PPPPP?PPPPPP.........
..................L.........
..................L....C....
....D.............L.........
..................L.........
?PPPPPPPPPPPPPPPPPPPPPPPPP..
.........................L..
.........H...............L..
.........................L..
.T...M...................L..
.........................L..
PPPPPPPPPPPPPP!PPPPPPPPPPPPP