........R....................
.......PPPPP!PPPPPP..........
..................L..........
..................L.....C....
..................L..........
....D.............L..........
?PPPPPPPPPPPPPPPPPPPPPPPPPPP.
.........H................L..
..........................L..
.T...M....................L..
PPPPPPPPPPPPPP!PPPPPPPPPPPPPP