........R...................
.......PPPPP!PPPPPP.........
..................L.........
..................L....C....
..................L.........
....D.............L.........
?PPPPPPPPPPPPPPPPPPPPPPPPP..
.........H...............L..
.........................L..
.T...M...................L..
PPPPPPPPPPPPPP!PPPPPPPPPPPPP